   P-J-P                                            PPPPPPPPPPPPPPPPPPPP                                                                              
   P   P                                            P                  P                                                                              
   P   P                                            P                  P             PPPPPPPPPPPPPPPPPP                                               
PPPP   PPPPPPPPPPPPPPPPPPPPPPPPPPPPPPPPPPPPPPPPPPPPPPPPPPPPPPPPPPPPPP  PPPPPPPPPPPPPPP                PPPPPPPPPPPPPPPPPPPPPPPPPPPPPPPPPPPPPPPPPPPPPPPP
P                                                                                    PP                                     P                        P
P                                                                                         PPPPPPP                           P                        P
P               P                  P                                                     P        P                         P                        P
P               P                  P                                                    P         P                         P                        P
P               P                  P                                                   P          P                                                  P
PPPPPPPPPPPPPPPPPPPPPPPPPPPPPPPPPPPPPPPPPPPPPPPPPPPPPPPPP PPPPPPPPPPPPPPPPPPPPPPPPPPPPPPPPPPPPPPPPPPPPPPPPPPPPPPPPPPPPPPPPPPPPPPPPPPPPPPPPPPPPPPPPPPPP
                                                        P                    P
                                                        PPPPPPPPPPPPPPPPPPPPPP